1. λόγος (POS: noun, translation: ['that which is said: word, sentence, speech, story, debate, utterance, argument', 'that which is thought: idea, conception, consideration, reason, reckoning, computation', 'an account, explanation, or narrative', 'subject matter', 'the word or wisdom of God, identified with Jesus in the New Testament, by whom the world was created; God the Son']): 43595 connections
2. ἀνήρ (POS: noun, translation: ['man (adult male)', 'husband', 'human being; a mortal (as opposed to a god)']): 37453 connections
3. θεός (POS: noun, translation: ['divine (used only in comparative: θεώτερος (theṓteros))']): 36662 connections
4. ἄνθρωπος (POS: noun, translation: ['human being; person (as differentiated from gods, beasts, etc.)', 'man, humanity', 'all human beings, mankind', 'female slave']): 29293 connections
5. βασιλεύς (POS: noun, translation: ['chief, master', 'emperor, king, lord, patron']): 25627 connections
6. ἀρχή (POS: noun, translation: ['beginning, origin', 'sovereignty, dominion, authority', 'the end of a rope or stick, the corner of a sheet']): 21083 connections
7. γῆ (POS: noun, translation: ['earth, land', 'country', 'soil']): 20319 connections
8. καλός (POS: noun, translation: ['beautiful; lovely', 'useful; helpful; appropriate', 'good; right; moral; virtuous; noble']): 19589 connections
9. ἡμέρα (POS: noun, translation: ['day', "a period of one's life", 'time', 'birthday', 'year', '↑ Beekes, Robert S. P. (2010), “ἦμαρ”, in Etymological Dictionary of Greek (Leiden Indo-European Etymological Dictionary Series; 10), with the assistance of Lucien van Beek, Leiden, Boston: Brill, →ISBN, page 518']): 18912 connections
10. χρόνος (POS: noun, translation: ['time (in the abstract sense)', 'specific time, period, term', 'lifetime', 'delay', 'tense']): 18327 connections
11. πατήρ (POS: noun, translation: ['father', 'epithet of Zeus', 'respectful address of an older man', 'author .mw-parser-output .defdate{font-size:smaller}', 'forefathers, ancestors', 'God the Father; (one of the three Persons of the Trinity)']): 17940 connections
12. υἱός (POS: noun, translation: ['son', 'child, not necessarily male', 'the Son; the Son of God (one of the three Persons of the Trinity, believed to have become incarnated in Jesus Christ)']): 17802 connections
13. γυνή (POS: noun, translation: ['woman, female', 'wife']): 17560 connections
14. νόμος (POS: noun, translation: ['usage, custom', 'law, ordinance', 'melody, strain', 'ancient type of song', 'kind of coin', 'course of masonry']): 16000 connections
15. ἔργον (POS: noun, translation: ["work, labour, task; work or deed of war; battle; peaceful contest; work of industry;  tillage; tilled land;  woman's work; weaving; deed, doing, action", 'work or deed of war; battle', 'peaceful contest', "work of industry;  tillage; tilled land;  woman's work; weaving", 'tillage; tilled land', "woman's work; weaving", 'deed, doing, action', 'thing or matter', 'that which is wrought or made; work; result of work, profit or interest', 'result of work, profit or interest', 'guild or company of workmen']): 15856 connections
16. πόλεμος (POS: noun, translation: ['war, battle']): 15837 connections
17. πρᾶγμα (POS: noun, translation: ['deed, act, fact', 'occurrence, matter, affair', 'thing, concrete reality', 'thing, creature', 'thing of consequence or importance', 'circumstances, affairs', 'trouble, annoyance']): 15153 connections
18. φύσις (POS: noun, translation: ['origin, birth', 'nature, quality, property', "later, the nature of one's personality: temper, disposition", 'form, shape', 'that which is natural: nature', 'type, kind', 'Nature, as an entity, especially of productive power', 'creature']): 14498 connections
19. ψυχή (POS: noun, translation: ['The animating principle of a human or animal body, vital spirit, soul, life (the animating principle of life).; ;  Life-breath, lifeblood (‘the animating principle of life’ in corporeal interpretation).; ;  Animating principle in primary substances, the source of life and consciousness.; ;  A person;', 'Life-breath, lifeblood (‘the animating principle of life’ in corporeal interpretation).', 'Animating principle in primary substances, the source of life and consciousness.', 'A person', 'Animate existence, viewed as a possession, one’s life.', 'The spirit or soul thought of as distinct from the body and leaving it at death  (the immortal part of a person).; ; A disembodied spirit, a shade or ghost (the spirit of a dead person).;', 'A disembodied spirit, a shade or ghost (the spirit of a dead person).', 'Spirit (animated attitude), conscious self, personality as centre of emotions, desires and affections, heart.; ;  The spirit of the universe, the immaterial principle of movement and life.;', 'The spirit of the universe, the immaterial principle of movement and life.', 'The mind (seat or organ of thought), (the faculty of) reason.', 'Butterfly.']): 14298 connections
20. χείρ (POS: noun, translation: ['hand', 'arm (or hand and arm taken together)', 'paw of an animal', 'finger']): 13923 connections
21. χώρα (POS: noun, translation: ['location, place, spot (see Latin locus)', 'the proper place', "one's place in life", 'piece of land: tract, land, field', 'country (opposite town), countryside', 'country, nation']): 12346 connections
22. πλῆθος (POS: noun, translation: ['a large number of things, a great number', 'majority, main portion', 'something of large size or magnitude', 'specifically: a large group of people: crowd, multitude, throng, mob', 'populace, people, general public', 'magnitude, size, extent; amount, quantity; ;  length;', 'amount, quantity', 'length']): 11872 connections
23. τρόπος (POS: noun, translation: ['a turn, way, manner, style', 'a trope or figure of speech', 'a mode in music', 'a mode or mood in logic', "the time and space on the battlefield when one side's belief turns from victory to defeat, the turning point of the battle"]): 11474 connections
24. θάλασσα (POS: noun, translation: ['sea', 'the Mediterranean Sea', 'channel', 'salt water']): 11054 connections
25. τόπος (POS: noun, translation: ['place, location', 'topic;  commonplace', 'position, office', 'opportunity, possibility']): 10237 connections
26. μέρος (POS: noun, translation: ['part, component, region', 'share, portion', "one's turn", 'heritage, lot, destiny', 'member of a set, kind, type']): 10061 connections
27. δῆμος (POS: noun, translation: ['district, country, land; ; the inhabitants of a district or land', 'the inhabitants of a district or land', 'the common people; ;  commoner;', 'commoner', 'free citizens, sovereign people; ; popular government, democracy; ; popular assembly;', 'popular government, democracy', 'popular assembly', 'township, commune; deme', 'name for a prostitute', 'faction in a circus']): 9764 connections
28. ναῦς (POS: noun, translation: ['a ship']): 9435 connections
29. ἀρετή (POS: noun, translation: ['goodness, excellence', 'manliness, prowess, rank, valour', ': virtue', ': a virtue, the virtues', 'character, reputation, glory, fame, dignity, distinction', 'miracle, wonder', '"your worship"', 'plaster']): 9144 connections
30. καιρός (POS: noun, translation: ['measure; proportion; fitness', 'period', 'the proper [[time] opportunity; prime, the right moment, the fatal spot', 'season; time', 'lifetime', 'the times', 'advantage; profit', '↑ Beekes, Robert S. P. (2010), “καιρός”, in Etymological Dictionary of Greek (Leiden Indo-European Etymological Dictionary Series; 10), with the assistance of Lucien van Beek, Leiden, Boston: Brill, →ISBN, page 617']): 8984 connections
31. γένος (POS: noun, translation: ['race, stock, kin; ; direct descent, as opposed to collateral relationship;', 'direct descent, as opposed to collateral relationship', 'offspring, descendant; ;  offspring, posterity;', 'offspring, posterity', 'race of beings; ; : clan, house,  dynasty, lineage. ; ; tribe, nation, race, as a subdivision of ἔθνος (éthnos); ; caste; ; breed of animals;', ': clan, house,  dynasty, lineage.', 'tribe, nation, race, as a subdivision of ἔθνος (éthnos)', 'caste', 'breed of animals', 'age, generation, time of life', 'sex, gender; ;  grammatical gender', 'grammatical gender', 'class, sort, kind; ;  the opposite of εἶδος (eîdos, “species”); ;  class; ;  genus; ; species of plant; crop, produce; material; ; element;', 'the opposite of εἶδος (eîdos, “species”)', 'class; ;  genus; ; species of plant; crop, produce; material;', 'genus', 'species of plant; crop, produce; material', 'element']): 8907 connections
32. κῦρος (POS: noun, translation: ['supreme power, authority', 'confirmation, validity, certainty']): 8743 connections
33. ἀνάγκη (POS: noun, translation: ['force', 'constraint', 'necessity']): 8644 connections
34. δόξα (POS: noun, translation: ['expectation .mw-parser-output .defdate{font-size:smaller}', 'opinion, judgement, belief', 'glory, honor, magnificence, praise', 'glory, splendor (especially of the shechinah), theophany, mandorla', 'reputation']): 8509 connections
35. θέα (POS: noun, translation: ['view, sight']): 8421 connections
36. μάχη (POS: noun, translation: ['battle; combat', 'quarrel; strife; dispute', 'contest; game', 'battlefield', 'contradiction; inconsistency']): 8351 connections
37. ἵππος (POS: noun, translation: ['a horse,  a mare', 'cavalry, horsemen']): 8172 connections
38. ποταμός (POS: noun, translation: ['river, stream', 'canal']): 8010 connections
39. αἰτία (POS: noun, translation: ['charge, accusation, imputation, blame, guilt, fault; ;  credit; ; expostulation, admonition;', 'credit', 'expostulation, admonition', 'cause', 'occasion, opportunity, motive', 'category']): 8004 connections
40. ὕδωρ (POS: noun, translation: ['water', 'rainwater; rain', 'sweat', 'time (originally in reference to waterclocks)', 'liquid']): 7942 connections
41. στρατηγός (POS: noun, translation: ['A leader or commander of an army: general', 'The top official in any capacity (often used of various Roman ranks: consul, magistrate, etc.)']): 7789 connections
42. χάρις (POS: noun, translation: ['beauty, elegance, charm, grace', 'favourable disposition towards someone: grace, favor, goodwill;  the grace or favor of God; a voluntary act of goodwill', 'the grace or favor of God', 'a voluntary act of goodwill', 'gratitude, thanks', 'influence (opposite force)', 'gratification, delight']): 7584 connections
43. οἶκος (POS: noun, translation: ['dwelling place, settlement, house', 'room, chamber', 'meeting tent, meeting house, hall, monument', 'birdcage', 'estate, inheritance', 'reigning family']): 7578 connections
44. τέλος (POS: noun, translation: ['aim, purpose, end goal, design, final cause (as used by Aristotle and the philosophers; cf. teleology)', 'completion, maturity, accomplishment, fulfillment, perfection, consummation', 'result, product', 'end', 'end of life: death', 'boundary, border, extremity', 'supreme power', 'the highest government office: magistrate', 'that which is ordered to be done: task, duty', 'money paid to the government: tax, toll', "a person's property, according to which he was classed", 'thus, generally: rank, class', 'unit of soldiers: legion, company', 'initiation (especially into mystery religions)', 'mystery religion', 'any religious ceremony']): 7030 connections
45. μήτηρ (POS: noun, translation: ['mother', 'source or origin']): 6966 connections
46. ναός (POS: noun, translation: ['a temple', 'innermost part of a temple, sanctuary, the part of the temple considered most pure and holy']): 6698 connections
47. γνώμη (POS: noun, translation: ['means of knowing: sign, mark', 'mind, intelligence', 'judgment, understanding, reason', 'will', 'opinion', 'decision']): 6686 connections
48. τεῖχος (POS: noun, translation: ['a wall, especially city wall', 'mound, earth works', 'fortified city', 'castle or fort']): 6546 connections
49. πολίτης (POS: noun, translation: ['citizen, freeman', 'fellow citizen, compatriot']): 6299 connections
50. πῦρ (POS: noun, translation: ['a fire; a funerary fire; a sacrificial fire', 'a funerary fire', 'a sacrificial fire', 'lightning', 'a fever']): 6248 connections
